12
1 1 n n n n n n n N n n n n n n n 1 1 1
1 1 n n n n n n n n n n n n n n n 1 1 1
1 1 n n n n n n n n n n n n n n n 1 1 1
1 1 0 0 0 0 0 0 0 n n n 0 0 0 0 n 1 1 1
1 1 0 0 0 0 0 0 0 0 n 0 0 0 0 0 0 e e e
1 1 1 0 0 0 0 0 0 0 0 0 0 0 0 0 0 e e e
1 1 1 1 0 0 0 0 0 0 0 0 0 0 0 0 0 e e E
1 1 1 1 1 1 1 0 0 0 0 0 0 0 0 0 1 1 1 1
w w w 0 0 0 0 0 0 0 0 0 0 0 0 0 1 1 1 1
w w w 0 0 0 0 0 0 1 1 0 0 0 0 1 1 1 1 1
W w w 0 0 0 0 s 1 1 1 1 s s 1 1 1 1 1 1
1 w w s s s s s s s s s s s 1 1 1 1 1 1
1 1 s s s S s s s s s s s 1 1 1 1 1 1 1
1 1 1 1 1 1 s s 1 1 1 1 1 1 1 1 1 1 1 1
finish
1 1 n n n n n n n n N n n n n n n 1 1 1
1 1 n n n n n n n n n n n n n n n 1 1 1
1 1 n n n n n n n n n n n n n n n 1 1 1
1 1 1 n n n n n n n n n n n n n n 1 1 1
1 1 1 1 n n n n n n n n n n n n n 1 1 1
1 1 1 1 1 1 1 1 1 1 1 n n n n n n 1 1 1
1 1 1 1 0 0 0 0 n 0 0 n n n n n n 1 1 1
1 1 1 0 0 0 0 0 0 0 0 0 0 1 1 1 1 1 1 1
w w w 0 0 0 0 0 0 0 0 0 0 1 1 1 e e e e
w w w 0 0 0 0 0 0 0 a 0 1 1 1 1 e e e e
W w w 0 0 0 0 0 0 1 1 1 1 1 e e e e e e
1 w w 0 0 0 0 0 0 e e e e e e e e e e E
1 1 w w 1 S s s 0 e e e e e e e e e 1 1
1 1 1 1 1 1 s s 1 1 1 1 1 1 1 1 1 1 1 1
finish
1 1 n n n n n n n N n n n n n n n 1 1 1
1 1 n n n n n n n n n n n n n n n 1 1 1
1 1 n n n n n n n n n n n n n n n 1 1 1
1 1 1 n n n n n 1 1 n n n n n n 1 1 1 1
1 1 1 1 n n n 1 1 1 n n n n n n 1 1 1 1
1 1 1 1 1 1 1 1 1 1 n n n n n n 1 1 1 1
1 1 1 1 0 0 0 0 0 0 0 0 0 0 0 1 1 1 1 1
1 1 1 0 0 0 0 0 0 0 0 0 0 1 1 1 1 1 1 1
w w w w 0 0 0 0 0 0 0 1 1 1 1 1 1 e e e
w w w w w 1 0 0 0 1 1 1 1 1 1 1 e e e e
W w w w w 1 0 0 0 1 1 1 e 1 e e e e e e
1 w w w 1 1 0 0 0 0 0 0 e e e e e e e E
1 1 w 1 1 1 S 0 0 0 0 0 0 e e e e e 1 1
1 1 1 1 1 1 1 s s 1 1 1 1 1 1 1 1 1 1 1
finish
1 1 1 1 1 1 1 1 n N n 1 1 1 1 1 1 1 1 1
1 1 1 1 1 0 0 n n n n 1 1 1 1 1 1 e e e
w w 0 0 0 0 0 n n n 1 1 0 0 1 1 e e e e
W w w 0 0 0 0 1 1 1 1 0 0 0 1 e e e e e
w w w w 0 0 0 0 0 0 0 0 0 0 0 0 e e e E
1 1 1 1 1 0 0 0 0 0 0 0 0 a 0 0 1 1 1 1
1 1 1 1 1 w w 0 0 1 1 1 1 1 1 1 1 1 1 1
1 1 1 w w w w 1 0 0 0 1 1 1 1 1 1 1 1 1
w w w w w w w 1 0 0 0 1 1 1 1 1 1 1 1 1
w w w w 1 1 1 1 1 1 0 1 1 1 1 1 1 1 1 1
w w w w s 1 1 1 s s 0 0 0 0 0 0 1 1 1 1
1 1 1 s s s s s s s 0 0 0 0 0 0 1 1 1 1
1 1 1 1 1 1 s s S 1 0 0 0 0 0 0 1 1 1 1
1 1 1 1 1 1 1 s 1 1 1 1 1 1 1 1 1 1 1 1
finish
1 1 1 1 1 1 1 1 n N n 1 1 1 1 1 1 1 1 1
1 1 1 1 1 1 1 1 n n n 1 1 1 1 1 1 1 1 1
1 1 1 1 1 1 1 1 n n n 1 1 1 1 1 1 1 1 1
1 1 1 1 1 1 1 1 n n n 1 1 1 1 1 1 1 1 1
1 1 1 1 1 1 1 1 n n n 1 1 1 1 1 1 1 1 1
1 1 1 1 1 1 1 0 0 0 0 0 1 1 1 1 1 1 1 1
w w w w w w 0 0 0 0 0 0 0 e e e e e e e
w w w w w w 0 z z z z z 0 e e e e e e e
W w w w w w 0 0 z z z 0 0 e e e e e e E
1 1 1 1 1 1 s s s z s s s 1 1 1 1 1 1 1
1 1 1 1 1 1 1 s s s s s 1 1 1 1 1 1 1 1
1 1 1 1 1 1 1 1 s s s 1 1 1 1 1 1 1 1 1
1 1 1 1 1 1 1 1 s S s 1 1 1 1 1 1 1 1 1
1 1 1 1 1 1 1 1 s 1 s 1 1 1 1 1 1 1 1 1
finish 
1 1 n n 1 1 1 1 1 1 1 1 1 1 n n n N 1 1
1 1 n n n n 1 1 0 0 0 1 1 n n n n n 1 1
1 1 1 n n n n 1 0 0 0 1 n n 1 1 1 1 1 1
1 1 1 1 n n n n 0 0 0 0 0 0 0 1 1 1 1 1
1 w w 1 1 n n n 0 a 0 0 0 0 0 0 1 1 e 1
w w w w w 1 1 1 1 1 1 0 0 0 0 0 1 e e 1
w w w w w 0 0 0 0 0 0 0 0 0 1 1 1 e e 1
W w w w w 0 0 0 0 0 0 0 0 1 1 1 1 e e e
1 1 1 1 w 0 0 0 0 0 0 0 e e e e e e e e
1 1 1 1 1 0 0 0 0 0 0 e e e e e e e e E
1 1 1 1 1 1 1 1 s s s 1 1 1 1 1 1 1 1 1
1 1 1 1 1 1 1 1 1 s s 1 1 1 1 1 1 1 1 1
1 1 1 1 1 1 1 1 1 S s 1 1 1 1 1 1 1 1 1
1 1 1 1 1 1 1 1 1 1 s 1 1 1 1 1 1 1 1 1 
finish
1 1 n n n n n n n N n n 1 1 1 1 1 1 1 1 
1 1 0 0 0 0 0 0 0 0 0 0 1 1 1 0 1 1 1 1 
1 1 0 0 0 0 0 1 1 1 1 1 1 1 1 0 0 1 1 1 
1 1 0 0 1 1 1 1 0 0 0 0 0 0 0 0 0 1 1 1 
1 1 0 0 0 0 0 0 0 0 0 0 0 0 0 0 0 1 1 1 
1 1 1 0 0 0 0 0 0 0 0 0 0 0 0 0 0 0 0 e 
1 1 1 0 1 1 1 0 0 0 0 0 0 0 0 0 0 0 0 e 
1 1 1 0 0 0 0 0 1 1 1 1 1 0 0 0 0 0 0 E 
1 1 1 0 0 0 0 0 0 0 0 0 0 0 0 0 1 1 1 1
1 1 1 1 1 1 1 0 0 0 0 0 a 0 0 1 1 1 1 1
w 0 0 0 0 0 0 0 0 1 1 1 1 1 1 1 1 1 1 1
w 0 0 0 0 0 0 0 1 1 1 1 1 1 1 1 1 1 1 1
W 0 0 0 0 0 S 1 1 1 1 1 1 1 1 1 1 1 1 1
1 1 1 1 s s 1 1 1 1 1 1 1 1 1 1 1 1 1 1 
finish
1 1 1 1 1 1 1 1 1 1 1 1 1 1 1 1 n N n 1
1 1 1 1 1 0 0 0 0 0 0 0 0 1 1 1 0 0 0 1
w 0 0 0 0 0 0 0 0 1 1 0 0 1 1 1 1 1 0 1
w 0 0 0 0 0 0 1 1 1 0 0 0 1 1 1 0 0 0 1
w 0 0 0 0 0 1 1 1 1 0 0 1 1 1 1 0 1 1 1
w 0 0 0 0 1 1 1 1 1 1 0 0 1 1 1 0 0 0 e
w 0 0 0 1 1 1 1 1 1 0 0 0 1 1 1 1 1 0 e
W 0 0 0 1 1 1 1 1 1 0 0 1 1 1 1 0 0 0 E
1 1 1 0 0 0 1 1 1 1 1 0 0 1 1 1 0 1 1 1
1 1 1 0 0 0 0 1 1 1 0 0 0 1 1 1 0 0 0 1
1 1 1 1 0 0 0 0 1 1 0 0 1 0 0 1 1 0 0 1
1 1 1 1 1 0 0 0 1 1 0 0 0 0 0 0 0 0 1 1
1 1 1 1 1 1 0 0 0 0 0 0 S 0 0 0 0 0 1 1
1 1 1 1 1 1 1 1 1 1 1 1 1 s s 1 1 1 1 1
finish
1 1 1 1 1 1 1 1 n N n n 1 1 1 1 1 1 1 1
1 0 0 0 0 0 0 0 0 0 0 1 1 1 1 0 0 1 1 1
1 0 0 0 0 0 0 0 0 0 1 1 0 1 0 0 0 1 0 1
1 0 0 1 1 1 1 n n 1 1 0 0 1 0 0 0 1 0 1
1 0 0 0 0 0 0 0 0 0 0 0 0 0 0 0 0 0 0 1
1 0 0 0 0 0 0 0 0 0 0 0 0 0 0 0 0 0 0 1
1 0 1 1 1 0 1 1 1 1 0 1 1 1 1 1 1 0 0 1
1 0 0 0 0 0 0 0 0 0 0 0 0 0 0 0 0 0 0 1
w 0 0 0 0 0 0 0 0 0 0 0 0 0 0 0 0 0 0 e
W 0 0 0 0 0 0 0 0 0 a 0 0 0 0 0 0 0 0 E
1 1 0 0 1 1 1 0 0 1 1 1 1 1 0 0 1 1 1 1
1 0 0 0 0 0 0 0 0 0 1 1 1 0 0 0 0 1 1 1
1 0 0 0 0 0 0 0 0 0 0 1 0 0 S 0 0 0 1 1
1 s s s s s s s s s s s s s 1 1 1 1 1 1
finish
1 n n n n n n n n N n n n n n n n n n 1
1 0 0 0 0 1 0 0 0 0 0 0 0 1 0 0 0 0 0 1
1 0 0 0 1 1 1 0 0 0 0 0 1 1 1 0 0 0 0 1
1 0 0 0 1 1 1 0 0 0 0 0 1 1 1 0 0 0 0 1
1 0 0 0 1 1 1 0 0 0 0 0 1 1 1 0 0 0 0 1
w 0 0 0 0 1 0 0 0 0 0 0 0 1 0 0 0 0 0 e
1 1 1 1 0 0 0 0 1 1 1 0 0 0 0 1 1 1 1 1
W 0 0 0 0 0 0 0 1 1 1 0 0 0 0 0 0 0 0 E
1 1 1 1 0 0 0 0 1 1 1 0 0 0 0 1 1 1 1 1
1 0 0 0 0 0 0 0 0 0 0 0 0 0 0 0 0 0 0 1
1 0 0 0 0 0 0 0 0 0 0 0 0 0 0 0 0 0 0 1
1 0 0 0 0 1 0 0 0 0 0 0 0 1 0 0 0 0 0 1
1 0 0 0 0 0 1 0 0 S a 0 1 0 0 0 0 0 0 1
1 s s s s s s 1 1 1 1 1 s s s s s s s 1
finish
1 1 1 1 1 n n n n n n n n n N 1 1 1 1 1 
w w 1 1 1 0 0 0 0 0 0 0 0 0 0 0 0 1 1 e
w 1 1 1 1 1 0 0 0 0 0 0 0 0 0 0 0 1 e e
w 1 1 1 1 1 0 0 0 0 0 0 0 0 0 0 0 1 e e
w w 1 1 1 0 0 0 0 0 0 0 0 0 1 0 0 0 e e
w w w 1 0 0 0 0 0 0 0 0 0 1 1 1 0 0 0 e
w w w 0 0 0 1 0 0 0 0 0 0 1 1 1 0 0 0 e
w w w 0 0 1 1 1 0 0 0 0 0 1 1 1 0 0 0 e
W w w 0 0 0 1 0 0 1 0 0 0 1 1 1 0 0 e E
1 1 1 0 0 0 0 0 1 1 1 0 0 1 1 1 0 1 1 1
1 1 1 0 0 0 0 0 0 1 0 0 0 0 1 0 0 0 1 1
1 1 1 0 0 0 0 0 0 0 0 0 0 0 0 0 0 0 1 1
1 1 1 1 S 0 0 0 0 0 0 0 0 0 0 0 0 0 1 1
1 1 1 1 1 s s s s s s s s s s s s s s 1
finish
1 n n n 1 1 1 n n N n n 1 1 1 n n n n 1
1 n n n 1 1 1 n n n n n 1 1 1 n n n n 1
1 n 0 0 1 1 1 n n n n n 1 1 1 n n n n 1
1 n 0 0 1 1 1 n n n n n 1 1 1 n n n n 1
1 w 0 0 1 1 1 0 0 0 0 0 1 1 1 n n 1 1 1
1 w 0 0 0 1 0 0 0 0 0 0 0 1 0 0 0 1 1 1
w w w 0 0 0 0 0 1 1 0 0 0 0 0 0 0 0 1 1
W w w w 0 0 0 0 1 1 1 0 0 0 0 0 0 0 0 e
1 1 1 w 0 0 0 0 1 1 1 1 0 a 0 0 0 0 0 E
1 1 1 1 0 0 0 0 0 1 1 1 1 1 1 1 1 1 1 1
1 1 1 1 s 0 0 0 0 0 1 1 1 1 1 1 1 1 1 1
1 1 1 1 s s 0 0 0 0 0 1 1 1 1 1 1 1 1 1
1 1 1 1 s s s S 0 0 0 0 1 1 1 1 1 1 1 1
1 1 1 1 s s s 1 1 1 1 1 1 1 1 1 1 1 1 1
finish